111111111111111111111111111111111111
100000000000000000000000000000000001
100C00000000000000000000000000000001
10C000000000000000000000000000000001
100000000000000000000000000000000001
100000000000000000000000000000000001
100000000000000000000000000000000001
100000000000000000000000000000000001
100000000000000000000000000000000001
1000000000000000000000000000P0000001
100000000000000000000000000000000001
1000000000000X0000000000000000000001
100000000000000000000000000000000001
100000000000000000000000000000000001
100000000000000000000000000000000001
100000000000000000000000000000000001
100000000000000000000000000000000001
100000000000001100000000000000000001
100000000000001100000000000000000001
100000000000000001000000000000000001
100000000000000010100000000000000001
100000000000000000000000000000000001
100000000000000000000000000000000001
1000000000000000000000000000E0000001
100000000000000000000000000000000001
100000000000000000111000000000000001
100000000000000000101000000000000001
100000000000000000111000000000000001
100000000000000000000000000000000001
100000000000000000000000000000000001
100000000000000000000000000000000001
100000000000000000000000000000000001
100000000000000000000000000000000001
100000000000000000000000000000000001
100000000000000000000000000000000001
111111111111111111111111111111111111