111111111111111111111111111111111111111111111111111111111111111111111111
100000000000000000000000000000000000000000011000000000000000000000000001
100C0000000000000000000000000000000000000CC00000000000000000000000000001
10C000000000000000000000000000000000000000001100000000000000000000000001
1000000000000000000000000000000000000000000CC000000000000000000000000001
10000000000000000000000000000000000000000000000CC00000000000000000000001
100000000000000000000000000000000000000000110000000000000000000000000001
100000000000000000000000000000000000000000000110000000000000000000000001
100000000000000000000000000000000000000000CC0000000000000000000000000001
100000000000000000000000000000000000000011000000000000000000000000000001
1000000000000000000000000000000000CC000000000000000000000000000000000001
10000000000000000000000000000000CC00000000000000000000000000000000000001
100000000000000000000000000110000000000000000000000000000000000000000001
10000000000000000001100000000000000000000000000P000000000000000000000001
100000000000000110000000000000000000000000000000000000000000000000000001
10000000000000000CC00000000000000000000000000000000000000000000000000001
100000000000011000000000000000000000000000000000000000000000000000000001
1000000CC000000011000000000000000000000000000000000000000000000000000001
100000000CC0000011000000000000000000000000000000000000000000000000000001
100001100000000000010000000000000000000000000000000000000000000000000001
10000000000CC00000101000000000000000000000000000000000000000000000000001
100110000000000000000000000000000000000000000000000000000000000000000001
100000000000000000000000000000000000001100000000000000000000000000000001
100000000000000000000000000000001100000000000000000000000000000000000001
100000000000000000000000000000000011000000000000000000000000000000000001
100000000000000000111000000000110000000000000000000000000000000000000001
10000000000000000010100001100000000000000000000000000000E000000000000001
100000000000000000111000000000000000110000000000000000000000000000000001
100000000000000000000CC0000000000000000000000000000000000000000000000001
1000000000000CC000000000000000000000000000000000000000000000000000000001
100000000000000CC0000000000000000000000000000000000000000000000000000001
1000000C000000000000000000000000000000000000000000000000000000C000000001
10000000C00C000000000000000000000000000000000000000000000000000000000001
100000000000C00000000000000000000000000000000000000000000000000000000C01
100000000000000000000000000000000000000000000000000000000000000000C00C01
111111111111111111111111111111111111111111111111111111111111111111111111