111111
1E0001
100C01
10C001
100P01
111111