111111
1P00E1
100C01

100001
111111