111111
1E0001
10JC01
10C001
100P01
111111