111111
1E1001
111C01
10C001
100P01
111111