11111111111111111111111111111111111111111111111111111111111111111111111111111111
100P0000000000000000000000011000000000000000000000000000000000000000000000000001
10000000000000000001100000000000000000000000000000000000000000000000000000000001
10000000000000011000000000000000000000000000000000000000000000000000000000000001
10000000000000000CC0000000000000000000000000000000000000000000000000000000000001
100000E0000001100000000000000000000000000000000000000000000000000000000000000001
1000000CC00000001100000000000000000000000000000000000000000000000000000000000001
100000000CC000001100000000000000000000000000000000000000000000000000000000000001
10000110000000000001000000000000000000000000000000000000000000000000000000000001
10000000000CC0000010100000000000000000000000000000000000000000000000000000000001
10011000000000000000000000000000000000000000000000000000000000000000000000000001
10000000000000000000000000000000000000110000000000000000000000000000000000000001
10000000000000000000000000000000110000000000000000000000000000000000000000000001
10000000000000000000000000000000001100000000000000000000000000000000000000000001
10000000000000000011100000000011000000000000000000000000000000000000000000000001
10000000000000000010100001100000000000000000000000000000000000000000000000000001
10000000000000000011100000000000000011000000000000000000000000000000000000000001
100000000000000000000CC000000000000000000000000000000000000000000000000000000001
1000000000000CC00000000000000000000000000000000000000000000000000000000000000001
100000000000000CC000000000000000000000000000000000000000000000000000000000000001
1000000C000000000000000000000000000000000000000000000000000000C00000000000000001
10000000C00C00000000000000000000000000000000000000000000000000000000000000000001
100000000000C00000000000000000000000000000000000000000000000000000000C0000000001
100000000000000000000000000000000000000000000000000000000000000000C00C0000000001
10011000000000000000000000000000000000000000000000000000000000000000000000000001
10011000000000000000000000000000000000000000000000000000000000000000000000000001
10011000000000000000000000000000000000000000000000000000000000000000000000000001
10011000000000000000000000000000000000000000000000000000000000000000000000000001
10011000000000000000000000000000000000000000000000000000000000000000000000000001
10011000000000000000000000000000000000000000000000000000000000000000000000000001
10011000000000000000000000000000000000000000000000000000000000000000000000000001
10011000000000000000000000000000000000000000000000000000000000000000000000000001
10011000000000000000000000000000000000000000000000000000000000000000000000000001
10011000000000000000000000000000000000000000000000000000000000000000000000000001
10011000000000000000000000000000000000000000000000000000000000000000000000000001
10011000000000000000000000000000000000000000000000000000000000000000000000000001
10011000000000000000000000000000000000000000000000000000000000000000000000000001
10011000000000000000000000000000000000000000000000000000000000000000000000000001
10011000000000000000000000000000000000000000000000000000000000000000000000000001
10011000000000000000000000000000000000000000000000000000000000000000000000000001
10011000000000000000000000000000000000000000000000000000000000000000000000000001
10011000000000000000000000000000000000000000000000000000000000000000000000000001
10011000000000000000000000000000000000000000000000000000000000000000000000000001
11111111111111111111111111111111111111111111111111111111111111111111111111111111
